NO ./assets/brick.png
SO ./assets/diomand.png
WE ./assets/emerald.png
EA ./assets/grass.png

F 220,100,0
C 225,30,0

1111111111111111111111111111111111
1000000000000000000000000000000001
1000000000000000000000000000000001
100000000000000000000000000000000111111111111111111111
100000000000000000000000000000000000000000000000000001
100000000000000000000000000000000000000000000000000001
1000000000000000N0000000000000000000000000000000000001
100000000000000000000000000000000000000000000000000001
100000000000000000000000000000000111111111111111111111
1000000000000000000000000000000000000000000000000000011111
1000000000000000000000000000000000000000000000000000000000111
10000000000000000000000000000000000000000000000000000000000001
1000000000000000000000000000000000000000000000000000000000000001
1111111111111111111111111111111111111111111111111111111111111111
