NO ./images/wall_no1.xpm
SO ./images/wall_so.xpm
WE ./images/wall_we.xpm
EA ./images/wall_ea.xpm

C 127,166,252
F 75,101,75

1111111111111111111111111111111111
1000000000100000N00010000000000001
10000000001111111111110000000000001
10000000000000000000000000000000011
10000000000000000000000000000000001
10000000000000000000000000000000001
10000001111111111111111111111111111
10000001
10000011
100000011111
100000000000111
10000000000000011
100000000000000001
1111111111111111111