NO ./images/wall_no.xpm
SO ./images/emerald.xpm
WE ./images/grass.xpm
EA ./images/brick.xpm

C 127,166,252
F 75,101,75

111111111
10000000011111
1000000000001111
1000000100000001
1000000000000001
100000000000001
1000N00000000001111
10000000000000000001
1000000000000001111
1000000000000001
1111111111111111
