NO ./assets/brick.png
SO ./assets/diomand.png
WE ./assets/emerald.png
EA ./assets/grass.png

C 231,23,2
F 23,12,23

111111111
10000000011111
1000000000001111
1000000000000001
1000000000000001
100000000000001
1000N00000000001111
10000000000000000001
1000000000000001111
1000000000000001
1111111111111111
