NO ./assets/brick.png
SO ./assets/diomand.png
WE ./assets/emerald.png
EA ./assets/grass.png

F 215,255,2
C 251,224,2

111111111
1000000001111
1000000000001111
1000000000000001
1000000000000001
1000000000000001
1000N00000000001111
10000000000000000001
1000000000000001111
1000000000000001
1111111111111111
