NO ./assets/brick.png
SO ./assets/diomand.png
WE ./assets/emerald.png
EA ./assets/grass.png

F 215,255,251
C 251,221,252
111111
100101
101001
1100N1
111111