NO ./assets/brick.png
SO ./assets/diomand.png
WE ./assets/emerald.png
EA ./assets/grass.png

F 215,255,2
C 251,224,2

111111
100001
101001
1000N1
111111