111111111111111111111
100000000000000000001
100000000000000000001
10000000000P000000001
100000000000000000001
1000000000C0000000001
100000000000000000001
1000000C000000C000001
100000000000000000001
100000000000000000001
1000000000E0000000001
100000000000000000001
111111111111111111111